NO ./imgs/wall_04.png
SO ./imgs/wall_01.png
EA ./imgs/wall_03.png
WE ./imgs/wall_02.png

C 105,105,105
F 127,127,127

11111111
10010001
1010N001
01000001
11111111