NO ./imgs/wooden_wall_chopper.png
SO ./imgs/wooden_wall_nami.png
EA ./imgs/wooden_wall_monkey.png
WE ./imgs/wooden_wall_nico.png

C               	10,20,30
F 					   40,50,60

1111111111111111111111111
1000100000000010001000001
1010101111111110101011101
1010001000100010100000101
1011111010101011111111101
1000101010001000100000001
1010101011111111101011111
1010100000100010001010001
1111101111101111111010101
1000001000101000100000101
1011111010101110111111101
1010001010100010001000001
1010111010111111111011101
1000000000000000001000101
1111111111111111111111101
                            111111
1000000000000000000000000000100001
1011111111111111111111111011101011
1010000000000000000000001000101001
1010111111111111111111101010111011
1010100000000000000000101010000001
1010111111111111111110101011111101
1000000000000000000101010000001001
1111111111111111111010111111111011
                    10000000000001
                    10N0111111111
                    1111111111111