NO ./imgs/wall_04.png
SO ./imgs/wall_01.png
EA ./imgs/wall_03.png
WE ./imgs/wall_02.png

F 0,0,0
C 255,255,255

1111111111111111111111111111111
1F0000000000000000000000000000011
10000000000000000000000000000011
10000000000000000000000000000011
100000000000000000000000000000011
10000000000000000000000000000011
1111111111111111111111111111111