C 210,209,8
F 19,20,21

NO ./imgs/wall_04.png
SO ./imgs/wall_01.png
EA 
WE ./imgs/wall_02.png

111111111111
100000000001
100010011101
100000000101
101110001101
100000000001
100011111111
10001
10011
10N01
11111