NO ./imgs/wall_extra_01.png
SO ./imgs/wall_extra_03.png
EA ./imgs/wall_extra_02.png
WE ./imgs/wall_extra_04.png

C 25,25,112
F 139,69,19
11111111111111111111111111111111111
1E000000000000000000000000000000001
10101010101110100000000001111111101
10001000100010100000000100000000101
10111011101010000000001111110110101
10000000101000000010100000000100001
11101110101111111010111110111110111
10001000100000101010000010100000101
10111010111110101011111010101110101
10001010001000101000001010000000101
11101011101111111111101111111111101
10001000000000000000100000100000001
10111111111111111111101110101111101
10000000000000000000001000100000001
11111111111111111111111111111111111