NO ./imgs/wall_04.png
SO ./imgs/wall_01.png
EA  ./imgs/wall_03.png
WE   ./imgs/wall_02.png
C    10,20,30
F              30,20,10
11111111111111111111111111111111111111111111111111111111111111111111111111111111
1E001001001001001001001001001001001001001001001001001001001001001001001001001001
10000000000000000000000000000000000000000000000000000000000000000000000000000001
11111011111011111011111011111011111011111011111011111011111011111011111011111011
10001000100010001000100010001000100010001000100010001000100010001000100010001001
10001000100010001000100010001000100010001000100010001000100010001000100010001001
11111011111011111011111011111011111011111011111011111011111011111011111011111011
10000000000000000000000000000000000000000000000000000000000000000000000000000001
10010010010010010010010010010010010010010010010010010010010010010010010010010001
11111111111111111111111111111111111111111111111111111111111111111111111111111111