NO ./imgs/malaca_04.png
SO ./imgs/malaca_01.png
EA ./imgs/malaca_03.png
WE ./imgs/malaca_02.png

C 9,24,51
F 48,27,104

111111111111
100000000001
10001S011101
100000000101
101110001101
100000000001
100011111111
10001
10011
10001
11111